1|16|7|4|D|Oscorp
1|16|2|d|I|
1|16|8|a|P|
1|16|4|9|J|
1
1|16|3|4|D|Riri30147
1|16|H|E|9|
1|16|6|B|I|
1|8|7|G|C|
1|18|I|F|9|
1|18|I|N|A|
1|18|3|1|C|
1
