1|16|3|4|D|Lizard
1|16|2|Z|O|
1|16|3|F|L|
1
1|16|5|4|D|Pengey99
1|16|3|A|J|
1
1|16|7|4|D|Vallet
1|16|7|d|H|
1|16|4|c|Q|
1|16|4|I|F|
1|16|1|J|J|
1|16|1|C|G|
1
