1|16|7|4|D|Pingu47024
1|16|5|F|I|
1|6|5|K|J|
1|18|1|I|C|
1|18|L|L|I|
1|18|8|X|C|
1
1|16|6|4|D|renemario2
1|16|3|d|F|
1|16|8|V|J|
1|18|3|4|E|
1|18|1|1|J|
1|18|6|T|I|
1|18|3|O|H|
1|18|6|c|I|
1|14|1|A|B|
1|14|2|5|O|
1|14|5|R|H|
1
