1|16|2|4|D|reinita
1|16|1|L|E|
1|16|1|L|C|
1|16|8|E|C|
1|16|1|G|B|
1|16|3|2|K|
1|16|7|d|C|
1|16|1|1|B|
1
