1|16|7|4|D|suhaira
1|16|6|d|G|
1|16|2|S|J|
1|16|2|a|G|
1
2|16|L|4|D|chamaco05
2|16|2|O|F|
2|16|L|L|K|
2|16|1|3|H|
2|16|3|1|C|
2
2|16|2|4|D|chamaco05
2|16|2|Q|G|
2|16|J|Q|D|
2|16|J|S|B|
2|16|8|O|K|
2|16|7|T|F|
2|16|2|R|F|
2|16|5|R|M|
2|16|2|C|J|
2|16|7|K|K|
2|16|7|a|C|
2|16|7|G|I|
2|16|5|O|J|
2
1|16|6|4|D|chamaco05
1|16|3|E|J|
1|16|3|M|B|
1|16|8|J|G|
1|16|7|Q|E|
1|16|7|M|F|
1|16|2|H|K|
1|16|4|K|F|
1|16|L|I|J|
1|16|4|d|C|
1|16|1|1|B|
1
1|16|7|4|D|BLODEYMEARY
1|16|7|K|B|
1
1|16|3|4|D|chamaco05
1|16|1|S|E|
1|16|4|M|J|
1|16|7|C|H|
1|16|7|V|F|
1|16|3|E|F|
1|16|6|I|J|
1|16|8|J|F|
1|16|2|R|J|
1|16|3|H|B|
1|16|1|N|A|
1|16|2|I|N|
1|16|1|O|O|
1|16|6|d|C|
1|16|4|I|N|
1|16|8|S|L|
1|16|L|K|L|
1|16|H|9|I|
1|16|H|9|E|
1|16|8|d|C|
1|16|2|L|L|
1|16|7|M|N|
1|16|5|D|A|
1|16|3|M|L|
1|16|7|L|K|
1
1|16|7|4|D|iamhere
1|16|1|d|G|
1|16|3|1|K|
1
