1|16|7|4|D|elsa31
1|16|7|4|D|
1|16|7|O|D|
1|16|1|K|M|
1|16|3|1|J|
1|16|7|1|I|
1|16|1|H|A|
1|16|4|I|H|
1|16|5|K|P|
1
2|16|7|4|D|seriously
2|16|3|3|J|
2
1|16|7|4|D|Madgirl1245
1|16|L|Y|I|
1|16|L|2|E|
1
