6|16|3|4|D|Rita
6|16|7|Y|N|
6|16|4|E|A|
6|16|3|1|N|
6|16|7|1|O|
6|16|6|J|F|
6|16|6|J|F|liol
6|16|5|c|I|
6
1|16|6|4|D|Lilly21344
1|16|7|W|L|
1|16|1|d|Q|
1|16|3|1|H|
1
8|16|5|4|D|23youtin.
8|16|7|b|Q|
8|16|3|5|K|
8|16|3|1|H|
8|16|4|8|M|
8|16|1|3|P|
8
1|16|6|4|D|mamama
1|16|7|d|H|
1|16|5|c|M|
1|16|3|1|C|
1
