2|16|7|4|D|Tennis
2
1|16|7|4|D|sk1ppy1
1|16|2|d|D|
1
1|16|7|4|D|sk1ppy1
1|16|5|1|D|
1
4|16|1|4|D|Arnold
4|16|7|N|M|
4|16|2|B|H|
4|16|5|G|J|
4|16|6|J|F|
4|16|5|2|F|
4
4|16|7|4|D|Arnold
4|16|7|b|E|
4|16|3|W|G|
4|16|L|a|H|
4|16|3|P|A|
4|16|3|C|L|
4|16|7|Z|R|
4|16|4|4|F|
4
1|16|6|4|D|Arnold
1|16|7|V|P|
1|16|4|S|I|
1
1|16|8|4|D|Arnold
1|16|7|a|I|
1|16|3|E|L|
1|16|3|T|N|
1|16|4|1|F|
1
