1|14|8|Q|G|jimbobfreddy
1|14|5|R|O|
1
3|14|7|Q|G|Gary3000
3|14|4|Q|G|
3|14|3|C|F|
3
1|13|7|Q|G|Lucas4856
1|13|5|H|L|
1|13|7|J|K|
1|13|H|N|K|
1|13|1|H|K|
1|13|7|M|M|
1|13|3|H|M|
1|13|8|L|L|
1
