1|16|7|4|D|nater
1|16|4|N|A|
1|16|1|T|F|
1|16|4|F|G|
1|16|4|E|D|
1|16|L|M|M|
1
3|16|7|4|D|kartairo
3|16|3|1|J|
5|16|5|4|D|zeta120
3
5|16|8|F|M|
4|16|8|4|D|elsa120
5|16|8|S|G|
4|16|7|K|H|
5|16|6|c|E|
4|16|7|b|D|
5|16|3|1|D|
4|16|6|b|J|
5|16|3|K|P|
4|16|3|2|D|
4
5|16|3|2|G|
5
3|16|2|4|D|kartairo
3|16|1|d|H|
3|16|3|d|Q|
3|16|3|M|K|
3|16|7|X|H|
3
1|16|6|4|D|skydosemc
1
1|16|1|4|D|Dommy
1|16|4|M|B|
1
1|16|7|4|D|Dommy
1|16|7|4|D|
1|18|1|d|E|
1
