1|16|8|4|D|Perry 822
1|16|3|Q|H|
1|18|3|Z|K|
1|1|5|d|C|
1|1|3|1|I|
1
1|16|3|4|D|julica
1|16|6|A|E|
1|16|7|d|F|
1|16|4|O|L|
1|16|8|6|A|
1|18|1|B|A|
1
1|16|7|4|D|victorh108
1|16|2|d|E|
1|16|2|H|F|
1
1|16|6|4|D|zeleste
1|16|1|d|F|
1|16|5|W|I|
1|16|3|N|H|
1
1|16|7|4|D|zeleste
1|16|1|P|M|
1|16|5|K|D|
1|16|7|T|M|
1|16|7|Q|N|
1|16|7|N|K|
1|16|6|R|L|
1|16|H|G|L|
1|16|1|H|I|
1|16|1|F|K|
1|16|5|6|D|
1
