1|16|5|4|D|AlCapwn
1|16|3|H|F|
1
1|16|7|4|D|Mayk124
1|16|7|d|J|
1
1|16|2|4|D|kolo780
1|16|7|U|G|
1|16|3|d|E|
1|16|1|1|K|
1|16|2|1|F|
1
2|16|8|4|D|____
2|16|4|U|B|
2|16|4|B|9|
2|16|7|H|C|
2|16|7|K|I|
2|16|1|I|H|
2|16|L|K|K|
2|16|6|P|M|
2|16|8|K|H|
2|16|3|F|G|
2|16|3|S|P|
2|16|6|a|H|
2|16|4|1|B|
2
2|16|6|4|D|____
2|16|3|O|P|
2|16|I|Q|F|
2|16|1|G|E|
2|16|5|d|D|
2|16|2|c|R|
2|16|4|1|B|
2
2|16|6|4|D|____
2
1|16|1|4|D|markiplier05
1
1|16|6|4|D|markiplier05
1
