2|16|7|4|D|Jesse
4|16|7|4|D|LordLion
4|16|7|Y|H|
2|16|7|c|E|
4|16|4|Q|J|
2|16|3|G|O|
4|16|6|8|G|
2|16|3|1|R|
4|16|7|3|P|
4|16|7|F|I|
2|16|7|D|9|
4|16|2|K|D|
2|16|7|1|D|
2
4|16|2|4|G|
4
2|16|1|4|D|Jesse
4|16|5|4|D|LordLion
4|16|6|4|D|
2|16|7|D|D|
2|18|1|K|H|
4|16|7|S|I|
2|18|1|M|D|
4|16|3|U|G|
4|16|5|M|F|
4|16|2|L|A|
2|18|L|M|D|
2|18|L|C|L|
2
4
2|16|5|4|D|Jesse
1|16|6|4|D|LordLion
1|16|7|V|G|
2|16|1|W|M|
1|16|1|O|K|
2|16|4|F|E|
1|16|6|P|H|
2|16|8|P|N|
1|16|6|B|D|
2|16|8|J|I|
1|16|3|V|O|
2|16|8|G|K|
1|16|3|E|D|
2|10|1|G|K|
1|16|2|N|J|
2|10|8|F|L|
1|16|7|U|B|
2|18|1|F|L|
1|16|2|E|M|
2|18|L|J|M|
1|16|7|Y|C|
1|16|2|Y|C|/e5
2|18|L|V|D|
1|16|3|2|C|
2|18|L|R|H|
1
2
8|16|6|4|D|mommy
8|16|3|1|C|
8
