1|16|7|4|D|yahoo12
1|16|3|L|O|
1|16|4|J|K|
1|16|1|K|O|
2|16|7|4|D|lol12
2|16|5|4|D|
2|16|7|I|P|
1|16|4|9|H|
1|16|2|F|Q|
1|16|5|G|A|
1|16|5|B|E|
2|16|4|Q|K|
2|16|7|N|E|
2
1
1|16|6|4|D|Oscorp
1|16|5|I|L|
1|16|6|K|J|
1
1|16|7|4|D|Gary3000
1|16|3|K|F|
1
