1|16|7|4|D|sylvie
1|16|3|Q|K|
1|16|1|d|N|
1|16|1|E|I|
1|16|5|L|I|
1
1|16|7|4|D|ghhg
1|16|7|A|C|
1
1|16|7|4|D|guirinho
1|16|8|8|B|
1|12|1|K|J|
1|12|1|N|C|
1
1|16|1|4|D|guirinho
1|12|1|4|D|
1|12|1|H|J|
1|12|3|J|Q|
1
1|16|7|4|D|guirinho
1|16|7|4|D|
1|12|1|L|G|
1|12|1|K|Q|
1
