1|16|7|4|D|pinkduck
1|16|8|5|A|
1|16|7|1|B|
1
1|16|L|4|D|Pepeus
1|16|5|d|L|
1|16|3|K|O|
1|16|1|b|E|
1|16|3|3|I|
1
