3|16|L|4|D|cubito528
3|16|1|X|L|
3|16|3|U|D|
3|16|3|d|C|
3
1|16|7|4|D|tiagomalex4
1|16|3|O|C|
1
1|16|7|4|D|danail23
2|16|6|4|D|Na4ko
1|16|3|4|G|
2|16|7|G|G|
1|16|3|8|H|
2|16|7|P|L|
1|16|7|b|J|
2|16|7|R|K|
1|16|4|M|D|
2|16|7|G|N|
1|16|3|K|J|
2|16|5|X|H|
1|16|8|K|A|
2|16|5|M|K|
1|16|8|L|E|
2|16|6|L|E|
1|16|2|D|B|
2|16|7|U|D|
1|16|7|S|H|
2|16|5|6|E|
1|16|8|K|H|
2|16|7|Y|G|
2|16|3|P|I|
1|16|5|J|G|
2|16|3|Y|G|
1|16|1|J|H|
2|16|8|L|I|
1|16|3|A|G|
2|16|2|K|H|
1|16|3|E|G|
2|16|7|H|H|
1|16|3|L|K|
1|16|5|D|A|
2
1
1|16|6|4|D|Anakin2309
1|16|3|V|I|
1
1|16|3|4|D|Anakin2309
1
1|16|6|4|D|Anakin2309
1|16|7|G|E|
2|16|4|4|D|Fabi
2|16|7|Q|D|
1|16|2|1|E|
1
1|16|8|4|D|Anakin2309
2|16|3|N|J|
1|16|8|C|G|lol
1|16|7|J|G|
1|16|3|J|G|seguime
2|16|1|I|C|
1|16|3|1|G|
2|16|1|I|C|Muere :D!!!
1
2
4|16|7|4|D|gabrieljr
4|16|3|d|R|
4
4|16|7|4|D|gabrieljr
4
4|16|7|4|D|gabrieljr
4|16|1|d|E|
4
2|16|7|4|D|minhthanh
2|16|3|1|L|
2
